01111111111111111110
00000000000000000000
00111011101110111010
00010010001000010010
00010010001000010010
00010011101110010010
00010010000010010010
00010010000010010000
00010011101110010010
00000000000000000000
01111111111111111110