11111111111111111111
00000000000000000000
10001010100001000010
10001010100010101001
10001010100000100001
10001010100001000001
10001010100010000001
10001010100010001001
11100100111011100010
00000000000000000000
11111111111111111111
00000000000000000000
00000000000000000000
00000000000000000000
00000000000000000000
00000000000000000000
00000000000000000000
00000000000000000000
00000000000000000000
00000000000000000000
