11111111111111111111
00000000000000000000
10001010100001000000
10001010100010101010
10001010100000100000
10001010100001000100
10001010100010000000
10001010100010001010
11100100111011100100
00000000000000000000
11111111111111111111