10000000000000000000
11000000000000000000
11100000000000000000
11110000000000000000
11111000000000000000
11111100000000000000
11111110000000000000
11111111000000000000
11111111100000000000
11111111110000000000
11111111111000000000
11111111111100000000
11111111111110000000
11111111111111000000
11111111111111100000
11111111111111110000
11111111111111111000
11111111111111111100
11111111111111111110