00000000000000000000
iiiiiiiiiiiiiiiiiiii
i111111111111111111i
i222222222222222222i
i333333333333333333i
i444444444444444444i
i555555555555555555i
m666666666666666666m
444444444ii444444444
meeeeeeeeeeeeeeeeeem