00000000000000000000
iiiiiiiiiiiiiiiiiiii
i111111111111111111i
i222222222222222222i
i333333333333333333i
i444444444444444444i
i555555555555555555i
i666666666666666666i