00000000000eeeeeee00
00000000000000000000
00000000000000000000
00000000000000000000
00000000000000000000
00000000000000000i00
00000000000000000i00
000000000ee000000i00
001000000ee000000i00
0011000eeee010000i00
0001000eee1010000i00
0000110ee11010000i00
0000m101100111110i00
0000m100110010000i00
0m00m001000000000i00
0m0mm000000010000i00
0m0m0m00100100000i00
0mm00m00010100000i00
00m00000201000000i00
iiiiiiiiiiiiiiiiii00