11111111111111111111
e0e0e0e0e0e0e0e0e0e0
e0e0e0e0e0e0e0e0e0e0
e0e0e0e0e0e0e0e0e0e0
e0e0e0e0e0e0e0e0e0e0
e0e0e0e0e0e0e0e0e0e0
e0e0e0e0e0e0e0e0e0e0
e1e0e0e0e0e0e0e0e0e0
e0e0e0e0e0e0e0e0e0e1
e0e0e1e0e0e0e0e0e0e0
e0e1e0e0e0e1e0e0e1e0
e0e0e0e0e0e0e0e0e0e0
e0e0e0e0e0e0e0e0e0e0
e0e0e0e0e0e0e1e0e0e0
e0e0e0e1e0e0e0e1e0e0
e0e0e0e0e0e0e0e0e0e0
e0e0e0e0e1e0e0e0e0e0
e0e0e0e0e0e0e0e0e0e0
e0e0e0e0e0e0e0e0e0e0
11111111111111111111