11111111111111111111
12222222222222222221
12333333333333333321
12344444444444444321
12345555555555554321
12345666666666654321
123456eeeeeeee654321
123456eiiiiiie654321
123456eieeeeie654321
123456eiemmeie654321
123456eiemmeie654321
123456eieeeeie654321
123456eiieeiie654321
123456eeeeeeee654321
123456666ee666654321
123455555ee555554321
123444444ee444444321
123333333ee333333321
122222222ee222222221
111111111ee111111111