11111111111111111111
12222222222222222221
12333333333333333321
12344444444444444321
12345555555555554321
12345666666666654321
123456eeeeeeee654321
123456emmmmmme654321
123456emeeeeme654321
123456ememmeme654321
123456ememmeme654321
123456emeeeeme654321
123456emmmmmme654321
123456eeeeeeee654321
12345666666666654321
12345555555555554321
12344444444444444321
12333333333333333321
12222222222222222221
11111111111111111111
