00010000000000010000
00101000000000010000
00101000000001110101
00100010000001010010
00100101000001110101
00100101000000000000
00100101000000000000
00100101000000000000
00100100001000100000
00100100010000010000
00100100010000010000
00100100010101010000
00101111010101010000
00100100010010010000
00100100010010010000
00100100010101010000
00100100010101010000
10100100010000010000
10100100010000010000
01000100001000100000
