00000000000000000000
00000000000000000000
i234000005500000432i
i32340005mm50004323i
i432340005500043234i
i043234000000432340i
i004323400004323400i
i000432340043234000i
i000043234432340000i
i005004323323400500i
i05m50043ee34005m50i
i05m50043ee34005m50i
i005004323323400500i
i000043234432340000i
i000432340043234000i
i004323400004323400i
i043234000000432340i
i432340005500043234i
i32340005mm50004323i
i234000005500000432i