00000000555500000000
00000005555550000000
00000005055550000000
00000005555550000000
00000005555550000000
00000000000550000000
05550055555553003030
05050555555553303030
05050555555553303030
05550555555533300330
05000555333333300030
05000553333333300030
05000553333333300030
05000053333333003300
00000003300000000000
00000003333330000000
00000003333330000000
00000003333030000000
00000003333330000000
00000000333300000000
