00000mmmm00mmmm00000
00000me3m00m4em00000
00000m3em00me4m0mmmm
mmmm0me3m00m4em0m5em
m1em0m3em00me4m0me5m
me1m0me3m00m4em0m5em
m1em0m3em00me4m0me5m
me1m0me3m00m4em0m5em
m1em0m3em00me4m0me5m
me1m0me3m00m4em0m5em
m1em0m3em00me4m0me5m
me1m0me3m00m4em0m5em
m1em0m3em00me4m0me5m
me1m0me3m00m4em0m5em
m1em0m3em00me4m0me5m
me1m0me3m00m4em0m5em
m1em0mmmm00mmmm0me5m
me1m000000000000m5em
m1em000000000000me5m
mmmm000000000000mmmm
